48 128 14 15 210
0 1 1 1 1 1 1 1 1 1 2 3 3 3 3 3 3 3 3 3 3 3 3 3 3 3 3 3 3 3 3 3 3 3 3 3 3 3 3 3 3 3 3 3 3 3 3 3 3 3 3 3 3 3 3 3 3 3 3 3 3 3 3 4 0 1 1 1 1 1 1 1 1 1 1 1 1 1 1 0 5 6 7 6 7 6 7 6 7 6 7 6 7 6 7 6 7 6 7 6 7 6 7 6 7 6 7 6 7 6 7 6 8 9 10 6 7 6 8 9 10 6 7 6 7 6 7 4 
5 11 12 13 14 11 12 13 14 3 3 3 3 3 3 3 3 3 3 3 3 3 3 3 3 3 3 3 3 3 3 3 3 3 3 3 3 3 3 3 3 3 3 3 3 3 3 3 3 3 3 3 3 3 3 3 3 3 3 3 3 3 3 4 5 15 16 15 16 15 16 15 16 15 16 15 16 15 16 4 5 15 16 15 16 15 16 15 16 15 16 15 16 15 16 15 16 15 16 15 16 15 16 15 16 15 16 15 16 15 16 15 8 9 10 15 16 15 8 9 10 15 16 15 16 15 16 4 
5 17 18 19 20 17 18 19 20 3 3 3 3 3 3 3 3 3 3 3 3 3 3 3 3 3 3 3 3 3 3 3 3 3 3 3 3 3 3 3 3 3 3 3 3 3 3 3 3 3 3 3 3 3 3 3 3 3 3 3 3 3 3 4 5 6 7 6 7 6 7 6 7 6 7 6 7 6 7 4 5 6 7 6 7 6 7 6 7 6 7 6 7 6 7 6 7 6 7 6 7 6 7 6 7 6 7 6 7 6 7 6 8 9 10 6 7 6 8 9 10 6 7 6 7 6 7 4 
5 21 22 23 24 21 22 23 24 3 3 3 3 3 3 3 3 3 3 3 3 3 3 3 3 3 3 3 3 3 3 3 3 3 3 3 3 3 3 3 3 3 3 3 3 3 3 3 3 3 3 3 3 3 3 3 3 3 3 3 3 3 3 4 5 15 16 15 16 15 16 15 16 15 16 15 16 15 16 4 5 15 16 15 16 15 16 15 16 15 16 15 16 15 16 15 16 15 16 15 16 15 16 15 16 15 16 15 16 15 16 15 8 9 10 15 16 15 8 9 10 15 16 15 16 15 16 4 
5 19 20 17 18 19 20 17 18 3 3 3 3 3 3 3 3 3 3 3 3 3 3 3 3 3 3 3 3 3 3 3 3 3 3 3 3 3 3 3 3 3 3 3 3 3 3 3 3 3 3 3 3 3 3 3 3 3 3 3 3 3 3 4 5 6 7 6 7 6 7 6 7 6 7 6 7 6 7 4 5 6 7 6 7 6 7 6 7 6 7 6 7 6 7 6 7 6 7 6 7 6 7 6 7 6 7 6 7 6 7 6 8 25 10 6 7 6 8 25 10 6 7 6 7 26 27 4 
5 23 24 21 22 23 24 21 22 3 3 3 3 3 3 3 3 3 3 3 3 3 3 3 3 3 3 3 3 3 3 3 3 3 3 3 3 3 3 3 3 3 3 3 3 3 3 3 3 3 3 3 3 3 3 3 3 3 3 3 3 3 3 4 5 15 16 15 16 15 16 15 16 15 16 15 16 15 16 4 5 15 16 15 16 15 16 15 16 15 16 15 16 15 16 15 16 15 16 15 16 15 16 15 16 15 8 9 10 15 16 15 28 29 30 31 32 32 28 29 30 15 16 15 16 33 34 4 
5 17 18 19 20 17 18 19 20 3 3 3 3 3 3 3 3 3 3 3 3 3 3 3 3 3 3 3 3 3 3 3 3 3 3 35 3 3 3 3 3 3 3 3 3 3 3 3 3 3 3 3 3 3 3 3 3 3 3 3 3 3 3 4 5 6 7 6 7 6 7 6 7 6 7 6 7 6 7 4 5 6 7 6 7 6 7 6 7 6 7 6 7 6 7 6 7 6 7 6 7 6 7 6 7 6 36 29 37 6 7 6 8 9 10 38 39 39 8 9 10 6 7 6 7 40 41 4 
5 21 22 42 43 43 44 23 24 3 3 3 3 3 3 3 3 3 3 3 3 3 3 3 3 3 3 3 3 3 3 3 3 3 3 3 3 3 3 3 3 3 3 3 3 3 3 3 3 3 3 3 3 3 3 3 3 3 3 3 3 3 3 4 5 15 16 15 16 15 16 15 16 15 16 15 16 15 16 45 2 15 16 15 16 15 16 15 16 15 16 15 16 15 16 15 16 15 16 15 16 15 16 15 16 15 8 9 10 31 32 32 8 9 10 38 39 39 8 9 10 31 32 32 32 46 47 4 
5 19 20 4 0 0 5 17 18 3 3 3 3 3 3 3 3 3 3 3 3 3 3 3 3 3 3 3 3 3 3 3 3 3 3 3 3 3 3 3 3 3 3 3 3 3 3 3 3 3 3 3 3 3 3 3 3 3 3 3 3 3 3 4 5 6 7 48 49 49 50 6 7 6 7 6 7 6 7 6 7 6 7 6 7 6 7 6 7 6 7 6 51 6 7 52 7 6 51 6 7 52 7 6 7 6 8 9 10 38 39 39 8 9 10 38 39 39 8 9 10 38 39 53 54 54 54 0 
55 43 43 56 0 0 55 43 43 43 44 3 3 3 3 3 3 3 3 3 3 3 3 3 3 3 3 3 3 3 3 3 3 3 3 3 3 3 35 3 3 3 3 53 57 3 3 3 35 3 3 3 35 3 3 3 35 3 3 3 3 3 3 4 5 15 16 58 59 59 60 15 16 15 16 15 16 15 16 15 16 15 16 15 61 62 16 15 61 62 16 15 63 15 16 63 16 15 63 15 16 63 16 15 16 15 8 9 10 38 39 39 8 9 10 38 39 39 8 9 10 38 39 29 29 64 65 4 
0 1 1 1 1 1 1 1 1 1 2 3 3 3 3 3 3 3 3 3 3 3 3 3 3 3 3 3 3 3 3 3 3 3 3 3 3 3 3 3 3 3 3 3 3 3 3 3 3 3 3 3 3 3 3 3 3 3 3 3 3 3 3 4 5 6 7 4 0 0 5 6 7 48 49 49 49 49 49 49 49 50 7 6 40 41 7 6 26 27 7 6 66 6 7 67 7 6 66 6 7 67 7 6 48 49 49 49 49 49 49 49 49 49 49 49 49 49 49 49 49 49 49 49 49 50 68 4 
5 3 3 3 3 3 3 3 3 3 3 3 3 3 3 3 3 3 3 3 3 3 3 3 3 3 3 3 3 3 3 3 3 3 3 3 3 3 3 3 3 3 3 3 3 3 3 3 3 3 3 3 3 3 3 3 3 3 3 53 57 3 3 4 5 69 70 4 0 0 5 69 70 58 59 59 59 59 59 59 59 60 70 69 46 47 70 69 33 34 70 69 70 69 70 69 70 69 70 69 70 69 70 69 58 59 59 59 59 59 59 59 59 59 59 59 59 59 59 59 59 59 59 59 59 60 68 4 
5 3 3 3 3 3 3 3 3 3 3 3 3 3 3 3 3 3 3 3 3 3 3 3 3 3 3 3 3 3 3 3 3 3 3 3 3 3 3 3 3 3 3 3 3 3 3 3 3 3 3 3 3 3 3 3 3 3 3 3 3 3 3 4 29 29 29 29 29 29 29 29 29 29 29 29 29 29 29 29 29 29 29 29 29 29 29 29 29 29 29 29 29 29 29 29 29 29 29 29 29 29 29 29 29 29 29 29 29 29 29 29 71 72 72 72 72 72 72 72 72 72 72 72 73 74 75 76 
5 3 3 3 3 3 3 3 3 3 3 3 3 3 3 3 3 3 3 3 3 3 3 3 3 3 3 3 3 3 3 3 3 3 3 3 3 3 3 3 3 3 3 3 3 3 3 3 3 3 3 3 3 3 3 3 3 3 3 3 3 3 3 4 29 29 29 29 29 29 29 29 29 29 29 29 29 29 29 29 29 29 29 29 29 29 29 29 29 29 29 29 29 29 29 29 29 29 29 29 29 29 29 29 29 29 29 29 29 29 29 29 74 29 29 29 29 29 29 29 77 29 29 29 76 74 75 76 
5 3 3 3 3 3 3 3 3 3 3 3 3 3 23 24 21 22 23 24 3 3 23 24 21 22 23 24 3 3 3 3 3 3 3 3 3 3 3 3 3 3 3 3 3 3 3 3 3 3 3 3 3 3 3 3 3 3 3 3 3 3 3 4 29 29 29 29 29 29 29 29 29 29 29 29 29 29 29 29 29 29 29 29 29 29 29 29 29 29 29 29 29 29 29 29 29 29 29 29 29 29 29 29 29 29 29 29 29 29 29 29 74 29 29 29 29 29 29 29 78 29 29 29 76 74 75 76 
5 3 3 3 3 3 3 3 3 3 3 3 3 3 17 18 19 20 17 18 3 3 17 18 19 20 17 18 3 3 3 3 3 3 3 3 3 3 3 3 3 3 3 3 3 3 3 3 3 3 3 3 3 3 3 3 3 3 3 3 3 3 53 0 29 29 29 29 29 29 29 29 29 29 29 29 29 29 29 29 29 29 29 29 29 29 29 29 29 29 29 29 29 29 29 29 29 29 29 29 29 29 29 29 29 29 29 29 29 29 29 29 74 29 79 80 29 29 81 82 82 83 29 29 84 85 75 76 
5 3 3 3 3 3 3 3 3 3 3 3 3 3 21 22 23 24 21 22 3 3 21 22 23 24 21 22 3 3 3 3 3 3 3 3 3 3 3 3 3 3 3 3 3 86 87 88 3 3 3 3 3 3 3 3 3 22 23 24 21 22 11 4 29 29 29 29 29 29 29 29 29 29 29 29 29 29 29 29 29 29 29 29 29 29 29 29 29 29 29 29 29 29 29 29 29 29 29 29 29 29 29 29 29 29 29 29 29 29 29 29 74 89 90 91 29 81 92 93 93 94 83 29 29 29 29 76 
5 3 3 3 3 3 3 3 3 3 3 3 3 3 19 20 35 95 95 35 3 3 35 96 96 35 19 20 3 3 3 3 3 3 3 3 3 86 97 98 99 100 101 102 103 104 102 104 102 104 102 104 105 104 106 107 104 20 17 18 19 20 17 4 29 29 29 29 29 29 29 29 29 29 29 29 29 29 29 29 29 29 29 29 29 29 29 29 29 29 29 29 29 29 29 29 29 29 29 29 29 29 29 29 29 29 29 29 29 29 29 29 74 80 89 29 29 108 72 72 72 73 94 82 82 82 82 109 
5 3 3 3 87 88 3 3 3 3 3 3 3 3 23 24 13 14 11 12 100 3 11 12 13 14 23 24 86 101 110 111 104 102 105 103 104 102 104 102 112 113 114 114 114 114 114 114 114 114 115 116 117 118 119 42 44 24 21 22 23 24 21 4 29 29 29 29 29 29 29 29 29 29 29 29 29 29 29 29 29 29 29 29 29 29 29 29 29 29 29 29 29 29 29 29 29 29 29 29 29 29 29 29 29 29 29 29 29 29 29 29 74 91 29 29 29 77 120 120 120 84 72 72 72 72 72 73 
5 102 104 102 104 102 104 105 104 102 106 107 103 102 17 18 19 20 17 18 104 103 17 18 19 20 35 18 113 114 114 114 115 116 117 118 114 114 115 116 117 118 119 121 114 114 114 115 122 123 117 117 117 117 123 4 5 18 19 42 43 43 43 56 29 29 29 29 29 29 29 29 29 29 29 29 29 29 29 29 29 29 29 29 29 29 29 29 29 29 29 29 29 29 29 29 29 29 29 29 29 29 29 29 29 29 29 29 29 29 29 29 124 82 82 125 29 78 126 126 126 120 127 29 29 29 29 76 
5 114 114 119 121 115 116 117 118 114 114 114 114 114 21 22 23 24 42 43 43 43 43 44 23 24 13 22 114 114 115 123 117 117 117 117 123 122 117 117 117 117 123 123 128 123 122 117 117 117 117 117 129 130 43 56 5 22 23 45 1 1 1 0 29 29 29 29 29 29 29 29 29 29 29 29 29 29 29 29 29 29 29 29 29 29 29 29 29 29 29 29 29 29 29 29 29 29 29 29 29 29 29 29 29 29 29 29 29 29 29 29 93 93 93 74 29 131 126 126 126 126 132 29 29 29 29 76 
5 123 128 123 123 117 117 117 117 123 122 123 123 42 44 20 17 18 4 0 0 0 0 5 17 18 19 20 122 128 129 130 43 43 133 134 117 117 129 130 43 43 133 134 117 117 117 117 117 117 129 135 136 0 0 0 5 20 17 29 29 64 65 4 29 29 29 29 29 29 29 29 29 29 29 29 29 29 29 29 29 29 29 29 29 29 29 29 29 29 29 29 29 29 29 29 29 29 29 29 29 29 29 29 29 29 29 29 29 29 29 29 71 72 72 85 29 77 126 126 126 126 132 29 29 29 29 76 
55 43 43 43 43 43 43 43 43 43 43 43 43 56 55 43 43 43 56 0 0 0 0 55 44 96 96 96 96 42 137 0 0 0 0 138 43 43 137 0 0 0 0 138 44 96 96 96 96 42 137 0 0 0 0 0 55 43 43 43 43 44 68 4 29 29 29 29 29 29 29 29 29 29 29 29 29 29 29 29 29 29 29 29 29 29 29 29 29 29 29 29 29 29 29 29 29 29 29 29 29 29 29 29 29 29 29 29 29 29 29 29 74 139 140 29 29 78 126 131 126 126 131 29 29 141 142 76 
0 0 0 0 0 0 0 0 0 0 0 0 0 0 0 0 0 0 0 0 0 0 0 0 0 59 59 59 59 0 0 0 0 0 0 0 0 0 0 0 0 0 0 0 0 59 59 59 59 0 0 0 0 0 0 0 0 0 0 0 0 5 68 4 29 29 29 29 29 29 29 29 29 29 29 29 29 29 29 29 29 29 29 29 29 29 29 29 29 29 29 29 29 29 29 29 29 29 29 29 29 29 29 29 29 29 29 29 29 29 29 29 74 75 143 82 125 78 126 120 126 126 127 29 29 144 145 76 
29 29 29 29 29 29 29 29 29 29 29 29 29 29 29 29 29 29 29 29 29 29 29 29 29 29 29 29 29 29 29 29 93 93 93 93 93 93 93 93 93 93 93 93 93 93 93 93 93 93 93 93 93 93 93 93 93 93 93 93 93 74 75 76 29 29 29 29 29 29 29 29 29 29 29 29 29 29 29 29 29 29 29 29 29 29 29 29 29 29 29 29 29 29 29 29 29 29 29 29 29 29 29 29 29 29 29 29 29 29 29 29 74 75 76 93 74 78 126 126 126 126 132 29 29 76 93 93 
29 29 29 29 29 29 29 29 29 29 29 29 29 29 29 29 29 29 29 29 29 29 29 29 29 29 29 29 29 29 29 29 93 71 72 72 72 72 72 73 93 71 72 72 72 72 72 72 73 71 72 72 72 72 72 72 72 72 72 72 73 74 75 76 29 29 29 29 29 29 29 29 29 29 29 29 29 29 29 29 29 29 29 29 29 29 29 29 29 29 29 29 29 29 29 29 29 29 29 29 29 29 29 29 29 29 29 29 29 29 29 29 74 75 84 72 85 78 126 126 126 126 132 29 29 84 73 93 
29 29 29 29 29 29 29 29 29 29 29 29 29 29 29 29 29 29 29 29 29 29 29 29 29 29 29 29 29 29 29 29 93 74 120 120 127 29 29 76 93 74 120 120 120 120 120 77 76 74 120 120 120 120 120 120 77 120 127 29 84 85 29 76 29 29 29 29 29 29 29 29 29 29 29 29 29 29 29 29 29 29 29 29 29 29 29 29 29 29 29 29 29 29 29 29 29 29 29 29 29 29 29 29 29 29 29 29 29 29 29 29 74 29 29 29 146 78 147 148 148 148 149 29 29 29 76 93 
29 29 29 29 29 29 29 29 29 29 29 29 29 29 29 29 29 29 29 29 29 29 29 29 29 29 29 29 29 29 29 29 93 74 126 126 132 79 80 84 72 85 126 126 126 126 126 78 76 74 148 150 126 147 148 148 78 148 149 29 29 29 29 76 29 29 29 29 29 29 29 29 29 29 29 29 29 29 29 29 29 29 29 29 29 29 29 29 29 29 29 29 29 29 29 29 29 29 29 29 29 29 29 29 29 29 29 29 29 29 29 29 74 29 79 80 151 78 149 29 29 29 29 29 29 29 76 93 
29 29 29 29 29 29 29 29 29 29 29 29 29 29 29 29 29 29 29 29 29 29 29 29 29 29 29 29 29 29 29 29 93 74 126 131 132 90 91 29 146 120 147 148 148 150 126 78 84 85 29 152 126 132 29 29 78 29 29 29 29 29 29 76 29 29 29 29 29 29 29 29 29 29 29 29 29 29 29 29 29 29 29 29 29 29 29 29 29 29 29 29 29 29 29 29 29 29 29 29 29 29 29 29 29 29 29 29 29 29 29 29 124 82 153 91 154 78 29 29 29 29 29 29 29 79 76 93 
29 29 29 29 29 29 29 29 29 29 29 29 29 29 29 29 29 29 29 29 29 29 29 29 29 29 29 29 29 29 29 29 93 74 126 120 132 29 155 156 152 126 132 29 29 152 126 78 127 29 29 151 148 149 29 156 78 29 29 81 82 82 82 109 29 29 29 29 29 29 29 29 29 29 29 29 29 29 29 29 29 29 29 29 29 29 29 29 29 29 29 29 29 29 29 29 29 29 29 29 29 29 29 29 29 29 29 29 29 29 29 29 71 72 85 154 29 78 29 29 29 29 29 29 81 82 109 93 
29 29 29 29 29 29 29 29 29 29 29 29 29 29 29 29 29 29 29 29 29 29 29 29 29 29 29 29 29 29 29 29 93 74 148 148 149 29 29 29 151 148 149 29 29 152 126 78 132 29 156 157 29 29 158 159 78 29 81 92 93 93 93 93 29 29 29 29 29 29 29 29 29 29 29 29 29 29 29 29 29 29 29 29 29 29 29 29 29 29 29 29 29 29 29 29 29 29 29 29 29 29 29 29 29 29 29 29 29 29 29 29 74 29 29 29 154 78 80 29 29 29 29 81 92 93 93 93 
29 29 29 29 29 29 29 29 29 29 29 29 29 29 29 29 29 29 29 29 29 29 29 29 29 29 29 29 29 29 29 29 93 74 29 143 82 160 161 29 29 29 29 29 29 151 148 78 149 29 155 79 80 158 159 29 78 81 92 93 93 93 93 93 29 29 29 29 29 29 29 29 29 29 29 29 29 29 29 29 29 29 29 29 29 29 29 29 29 29 29 29 29 29 29 29 29 29 29 29 29 29 29 29 29 29 29 29 29 29 29 29 74 29 29 29 162 163 91 29 29 29 81 92 93 93 93 93 
29 29 29 29 29 29 29 29 29 29 29 29 29 29 29 29 29 29 29 29 29 29 29 29 29 29 29 29 29 29 29 29 93 74 29 76 93 93 164 165 161 29 29 29 29 29 29 78 29 81 82 153 91 159 143 82 82 166 93 93 93 93 93 93 29 29 29 29 29 29 29 29 29 29 29 29 29 29 29 29 29 29 29 29 29 29 29 29 29 29 29 29 29 29 29 29 29 29 29 29 29 29 29 29 29 29 29 29 29 29 29 29 74 29 29 29 158 77 29 29 29 29 108 72 72 72 72 73 
29 29 29 29 29 29 29 29 29 29 29 29 29 29 29 29 29 29 29 29 29 29 29 29 29 29 29 29 29 29 29 29 93 74 75 76 93 93 93 93 164 165 161 29 29 29 29 78 81 92 93 74 29 29 76 93 93 93 93 93 93 93 93 93 29 29 29 29 29 29 29 29 29 29 29 29 29 29 29 29 29 29 29 29 29 29 29 29 29 29 29 29 29 29 29 29 29 29 29 29 29 29 29 29 29 29 29 29 29 29 29 29 74 29 29 156 159 78 29 29 29 29 29 29 29 140 167 76 
29 29 29 29 29 29 29 29 29 29 29 29 29 29 29 29 29 29 29 29 29 29 29 29 29 29 29 29 29 29 29 29 93 74 75 76 93 93 93 93 93 93 164 82 125 142 143 82 166 93 93 74 142 142 76 93 93 93 93 93 93 93 93 93 29 29 29 29 29 29 29 29 29 29 29 29 29 29 29 29 29 29 29 29 29 29 29 29 29 29 29 29 29 29 29 29 29 29 29 29 29 29 29 29 29 29 29 29 29 29 29 29 74 142 142 142 162 168 168 169 142 143 82 82 82 125 75 76 
29 29 29 29 29 29 29 29 29 29 29 29 29 29 29 29 29 29 29 29 29 29 29 29 29 29 29 29 29 29 29 29 93 74 75 76 93 93 93 93 93 93 93 93 74 145 76 93 93 93 93 74 145 145 76 93 93 93 93 93 93 93 93 93 29 29 29 29 29 29 29 29 29 29 29 29 29 29 29 29 29 29 29 29 29 29 29 29 29 29 29 29 29 29 29 29 29 29 29 29 29 29 29 29 29 29 29 29 29 29 29 29 74 145 145 145 170 170 170 170 145 76 93 93 93 74 75 76 
3 3 3 3 3 3 3 3 3 3 3 3 3 3 3 3 3 3 3 3 3 3 3 3 3 3 3 3 3 3 3 3 93 74 75 76 93 93 93 93 93 93 93 93 93 93 93 93 93 93 93 93 93 93 93 93 93 93 93 93 93 93 93 93 93 93 93 93 93 93 93 93 93 93 93 93 93 93 93 93 74 3 3 3 3 3 3 3 3 3 3 3 3 3 3 3 3 3 3 3 3 3 3 3 3 3 3 3 3 3 3 76 93 93 71 72 72 72 72 72 72 72 72 72 73 74 75 76 
3 3 3 3 3 3 3 3 3 3 3 3 3 3 3 3 3 3 3 3 3 3 3 3 3 3 3 3 3 3 3 3 93 74 75 76 71 72 72 72 73 71 72 72 72 72 72 72 72 72 72 72 72 72 72 72 72 72 72 72 72 72 72 72 72 72 73 93 71 72 72 72 72 72 72 72 73 93 93 93 74 3 3 3 3 3 3 3 3 3 3 3 3 3 3 3 3 3 3 3 3 3 3 3 3 3 3 3 3 3 3 76 93 93 74 120 120 120 120 120 120 120 120 120 76 74 75 76 
3 3 3 3 3 3 3 3 3 3 3 3 3 3 3 3 3 3 3 3 3 3 3 3 3 3 3 3 3 3 3 3 93 74 75 76 74 120 120 120 76 74 120 120 120 120 120 77 120 120 120 77 120 120 120 120 120 120 120 120 120 77 120 120 120 120 76 93 74 29 146 120 120 77 120 120 76 93 93 93 74 3 3 3 3 3 3 3 3 3 3 3 3 3 3 3 3 3 3 3 3 3 3 3 3 3 3 3 3 3 3 76 93 93 74 126 126 126 126 126 126 126 126 126 76 74 75 76 
3 3 3 3 3 3 3 3 3 3 3 3 3 3 3 3 3 3 3 3 3 3 3 3 3 3 3 3 3 3 3 3 93 74 29 76 74 148 148 148 76 74 148 150 126 147 148 78 148 148 150 78 126 126 126 126 126 126 147 148 150 78 126 126 126 126 84 72 85 29 152 126 126 78 126 126 76 93 93 93 74 3 3 3 3 3 3 3 3 3 3 3 3 3 3 3 3 3 3 3 3 3 3 3 3 3 3 3 3 3 3 76 93 93 74 148 148 148 148 148 148 148 148 148 76 74 75 76 
3 3 3 3 3 3 3 3 3 3 3 3 3 3 3 3 3 3 3 3 3 3 3 3 3 3 3 3 3 3 3 3 71 85 29 84 85 79 80 29 84 85 29 152 126 132 162 168 169 29 151 78 148 148 148 150 126 126 132 29 151 78 148 148 148 150 120 77 127 29 151 148 148 78 148 148 76 93 93 71 85 3 3 3 3 3 3 3 3 3 3 3 3 3 3 3 3 3 3 3 3 3 3 3 3 3 3 3 3 3 3 84 73 93 74 171 172 172 172 172 172 172 172 173 76 74 75 76 
3 3 3 3 3 3 3 3 3 3 3 3 3 3 3 3 3 3 3 3 3 3 3 3 3 3 3 3 3 3 3 3 74 120 126 127 29 90 91 154 29 29 29 151 148 149 29 77 29 29 29 78 29 29 29 152 126 126 132 29 29 78 29 29 29 151 148 78 149 29 29 29 29 78 29 29 84 72 72 85 174 175 176 176 176 176 175 176 176 176 176 175 176 176 176 176 175 176 176 176 176 175 176 176 176 176 175 176 176 176 176 174 84 72 85 29 29 29 29 29 29 156 157 29 76 74 75 76 
3 3 3 3 3 3 3 3 3 3 3 3 3 3 3 3 3 3 3 3 3 3 3 3 3 3 3 3 3 3 3 3 74 148 148 149 29 29 154 29 154 29 177 178 29 29 79 78 29 81 82 82 160 161 29 151 148 148 149 29 162 168 169 29 29 29 29 78 29 29 79 80 162 168 169 156 29 29 29 179 180 181 182 183 184 182 181 182 183 184 182 181 182 183 184 182 181 182 183 184 182 181 182 183 184 182 181 182 183 184 182 180 185 29 29 29 29 29 29 29 29 155 79 80 76 74 75 76 
3 3 3 3 3 3 3 3 3 3 3 3 3 3 3 3 3 3 3 3 3 3 3 3 3 3 3 3 3 3 3 3 124 82 83 29 29 29 29 154 79 80 89 29 29 29 90 78 81 92 93 93 93 164 165 161 29 29 29 29 29 77 29 29 156 29 29 78 29 29 90 91 29 77 158 159 29 29 29 186 187 188 189 190 191 189 188 189 190 191 189 188 189 190 191 189 188 189 190 191 189 188 189 190 191 189 188 189 190 191 189 187 192 29 29 29 29 29 29 29 29 29 90 91 76 74 75 76 
3 3 3 3 3 3 3 3 3 3 3 3 3 3 3 3 3 3 3 3 3 3 3 3 3 3 3 3 3 3 3 3 93 93 193 83 29 29 29 29 194 91 29 29 29 81 82 82 166 93 93 93 93 93 93 164 165 161 29 29 29 78 80 158 159 29 81 82 83 29 155 157 29 78 159 29 195 196 82 125 197 198 199 199 199 199 198 199 199 199 199 198 199 199 199 199 198 199 199 199 199 198 199 199 199 199 198 199 199 199 199 197 143 82 125 29 29 29 29 29 29 29 29 29 84 85 75 76 
3 3 3 3 3 3 3 3 3 3 3 3 3 3 3 3 3 3 3 3 3 3 3 3 3 3 3 3 3 3 3 3 93 93 93 193 83 29 29 29 144 29 29 29 81 92 93 93 93 93 93 93 93 93 93 93 93 164 165 161 29 78 91 159 29 81 92 93 193 83 29 155 79 78 195 196 200 93 93 124 125 170 170 170 170 170 170 170 170 170 170 170 170 170 170 170 170 170 170 170 170 170 170 170 170 170 170 170 170 170 170 143 109 93 74 80 29 29 29 29 29 29 29 29 29 140 201 76 
3 3 3 3 3 3 3 3 3 3 3 3 3 3 3 3 3 3 3 3 3 3 3 3 3 3 3 3 3 3 3 3 93 93 93 93 193 125 142 142 144 142 142 143 166 93 93 93 93 93 93 93 93 93 93 93 93 93 93 164 82 82 82 125 142 108 72 72 72 202 142 143 82 82 203 93 93 93 93 93 74 3 3 3 3 3 3 3 3 3 3 3 3 3 3 3 3 3 3 3 3 3 3 3 3 3 3 3 3 3 3 76 93 93 124 153 142 142 142 142 142 142 142 143 82 82 82 109 
3 3 3 3 3 3 3 3 3 3 3 3 3 3 3 3 3 3 3 3 3 3 3 3 3 3 3 3 3 3 3 3 93 93 93 93 93 74 145 145 144 145 145 76 93 93 93 93 93 93 93 93 93 93 93 93 93 93 93 93 93 93 93 74 145 170 170 170 170 170 145 76 93 93 93 93 93 93 93 93 74 3 3 3 3 3 3 3 3 3 3 3 3 3 3 3 3 3 3 3 3 3 3 3 3 3 3 3 3 3 3 76 93 93 93 74 145 145 145 145 145 145 145 76 93 93 93 93 
