48 128 14 15 210
0 0 0 0 0 0 0 0 0 0 0 0 0 0 0 0 1 1 1 1 1 1 1 1 1 1 1 1 1 1 1 1 1 1 1 1 1 1 1 1 1 1 1 1 1 1 1 1 1 1 1 1 1 1 1 1 1 1 1 1 1 1 1 1 1 1 1 1 1 1 1 1 1 1 1 1 1 1 1 1 1 1 1 1 1 1 1 1 1 1 1 1 1 1 1 1 1 1 1 1 1 1 1 1 1 1 1 1 1 1 1 1 1 1 1 1 1 1 1 1 1 1 1 1 1 1 1 1 
0 1 1 1 1 1 1 1 1 1 1 1 1 1 1 0 1 1 1 1 1 1 1 1 1 1 1 1 1 1 1 1 1 1 1 1 1 1 1 1 1 1 1 1 1 1 1 1 1 1 1 1 1 1 1 1 1 1 1 1 1 1 1 1 1 2 3 4 1 1 1 1 1 1 1 1 1 1 1 1 1 1 1 1 1 1 2 3 4 1 1 1 1 1 1 1 1 1 1 1 1 1 1 1 1 1 1 1 1 1 1 1 1 1 1 1 1 1 1 1 1 1 1 1 1 1 1 1 
0 1 1 1 1 1 1 1 1 1 1 1 1 1 1 0 1 1 1 1 1 1 1 1 1 1 1 1 1 1 1 1 1 1 1 1 1 1 1 1 1 1 1 1 1 1 1 1 1 1 2 3 4 1 1 1 1 1 1 1 1 1 1 1 1 5 6 7 1 1 1 1 1 1 1 1 1 1 1 1 1 1 1 1 1 1 5 6 7 1 1 1 1 1 1 1 1 1 1 1 1 1 1 1 1 1 1 1 1 1 1 1 1 1 1 1 1 1 1 1 1 1 1 1 1 1 1 1 
0 1 1 1 1 1 1 1 1 1 1 1 1 1 1 0 1 1 1 1 1 1 1 1 1 1 1 1 1 1 1 1 1 1 1 1 1 1 1 1 1 1 1 1 1 1 1 1 1 1 5 6 7 1 1 1 1 1 1 1 1 1 1 1 1 1 8 9 1 1 1 1 1 1 1 1 1 1 1 1 1 1 1 1 1 1 1 8 9 1 1 1 1 1 1 1 1 1 1 1 1 1 1 1 1 1 1 1 1 1 1 1 1 1 1 1 1 1 1 1 1 1 1 1 1 1 1 1 
0 1 1 1 1 1 1 1 1 1 1 1 1 1 1 1 1 1 1 1 1 1 1 1 1 1 1 1 1 1 1 1 1 1 1 1 1 1 1 1 1 1 1 1 1 1 1 1 1 1 1 8 9 1 1 1 1 1 1 1 1 1 1 1 1 1 1 10 1 1 1 1 1 1 1 1 1 1 1 1 1 1 1 1 1 1 1 1 10 1 1 1 1 1 1 1 1 1 1 1 1 1 1 1 1 1 1 1 1 1 1 1 1 1 1 1 1 1 1 1 1 1 1 1 1 1 1 1 
0 0 0 0 0 0 1 1 1 1 1 1 1 1 1 1 1 1 1 1 1 1 1 1 1 1 1 1 1 1 1 1 1 1 1 1 1 1 1 1 1 1 1 1 1 1 1 1 1 1 1 1 10 1 1 1 1 1 1 1 1 1 1 1 1 1 1 11 1 1 1 1 1 1 1 1 1 1 1 1 1 1 1 1 1 1 1 1 11 1 1 1 1 1 1 1 1 1 1 1 1 1 1 1 1 1 1 1 1 1 1 1 1 1 1 1 1 1 1 1 1 1 1 1 1 1 1 1 
0 12 13 13 14 14 1 1 1 1 1 1 1 1 1 1 1 1 1 1 1 1 1 1 1 1 1 1 1 1 1 1 1 1 1 1 1 1 1 1 1 1 1 1 1 1 1 1 1 1 1 1 11 1 1 1 1 1 1 1 1 1 1 1 1 1 1 11 1 1 1 1 1 1 1 1 1 1 1 1 1 1 1 1 1 1 1 1 11 1 1 1 1 1 1 1 1 1 1 1 1 1 1 1 1 1 1 1 1 1 1 1 1 1 1 1 1 1 1 1 1 1 1 1 1 1 1 1 
0 15 0 0 0 0 0 1 1 1 0 0 0 0 0 0 0 0 0 0 0 1 1 1 1 1 1 1 1 1 1 1 1 1 1 1 1 1 1 1 1 1 1 1 1 1 1 1 1 1 1 1 11 16 17 1 1 1 1 1 1 1 1 1 1 1 1 11 1 1 1 1 1 1 1 1 1 1 1 1 1 1 1 1 1 1 1 1 11 1 1 1 1 1 1 1 1 1 1 1 1 1 1 1 1 18 19 20 1 1 1 1 1 1 1 1 1 1 1 1 1 1 1 1 1 1 1 1 
0 15 0 1 1 1 1 1 1 1 1 1 1 1 1 0 1 1 1 1 1 1 1 1 1 1 1 1 1 1 1 1 1 1 1 1 1 1 1 1 1 1 1 1 1 1 1 1 1 1 1 1 10 21 1 1 1 1 1 1 1 1 1 1 1 1 1 11 1 1 1 1 1 1 1 1 1 1 1 1 1 1 1 1 1 1 1 1 11 1 1 1 1 1 22 23 24 23 24 25 1 1 1 1 1 26 27 21 1 1 1 1 1 1 1 1 1 1 1 1 1 1 1 1 1 1 1 1 
0 15 0 1 1 1 1 0 0 0 1 1 1 1 1 0 1 1 1 1 1 1 1 1 1 1 1 1 1 1 1 1 1 1 1 1 1 1 1 1 1 1 1 1 1 1 1 1 1 1 1 1 11 1 1 1 1 1 28 24 24 24 24 24 24 24 29 24 23 24 24 24 24 24 24 24 30 1 1 28 24 24 24 24 24 24 24 29 24 23 24 24 24 24 24 23 24 30 1 1 1 1 1 1 1 1 11 1 1 1 1 1 1 1 1 1 1 1 1 1 1 1 1 1 1 1 1 1 
0 15 0 1 1 1 1 1 1 1 1 1 1 1 1 0 1 1 1 1 1 1 1 1 1 1 1 1 1 1 1 1 1 1 1 1 1 1 1 1 1 1 1 1 1 1 1 1 1 1 16 17 11 1 1 1 1 1 31 32 33 33 33 33 33 33 33 34 33 33 33 33 33 33 33 35 36 1 1 31 32 33 33 33 33 33 33 33 34 33 33 33 33 33 33 33 35 36 1 1 1 1 1 1 1 1 11 1 1 1 1 1 1 1 1 1 1 1 1 1 1 1 1 1 1 1 1 1 
0 15 0 1 1 1 1 1 1 1 1 1 1 1 1 0 1 1 1 1 1 1 1 1 1 1 1 1 1 1 1 1 1 1 1 1 1 1 1 1 1 1 1 1 1 1 1 1 1 1 1 26 10 1 1 1 1 1 1 37 38 39 40 40 40 41 42 43 44 45 40 40 40 41 42 46 1 1 1 1 37 38 39 40 40 40 41 42 43 44 45 40 40 40 41 42 46 1 1 1 1 1 1 1 1 1 11 16 17 1 1 1 1 1 1 1 1 1 1 1 1 1 1 1 1 1 1 1 
0 15 0 1 1 1 1 1 1 1 1 1 1 1 1 0 1 1 1 1 1 1 1 1 1 1 1 1 1 1 1 1 1 1 1 1 1 1 1 1 1 1 1 1 1 1 1 1 1 1 1 1 11 1 1 1 1 1 1 1 1 1 1 1 1 1 1 11 47 47 48 1 1 1 1 1 1 1 1 1 1 1 1 1 1 1 1 1 11 47 47 48 1 1 1 1 1 1 1 1 1 1 1 1 1 1 10 21 1 1 1 1 1 1 1 1 1 1 1 1 1 1 1 1 1 1 1 1 
0 15 0 1 1 1 1 1 1 1 1 1 1 1 1 0 1 1 1 1 1 1 1 1 1 1 1 1 1 1 1 1 1 1 1 1 1 1 1 1 1 1 1 1 1 1 1 1 1 1 1 1 11 1 1 1 1 1 1 1 1 1 1 1 1 1 1 11 49 49 50 1 1 1 1 1 1 1 1 1 1 1 1 1 1 1 1 1 11 49 49 50 1 1 1 1 1 1 1 1 1 1 1 1 1 1 11 1 1 1 1 1 1 1 1 1 1 1 1 1 1 1 1 1 1 1 1 1 
0 15 0 1 1 1 1 1 1 1 1 1 1 1 1 0 1 1 1 1 1 1 1 1 1 1 1 1 1 1 1 1 1 1 1 1 1 1 1 1 1 1 1 1 1 1 1 1 1 1 1 1 11 16 17 1 1 1 1 1 1 1 1 1 1 1 1 11 51 47 47 48 1 1 1 1 1 1 1 1 1 1 1 1 1 1 1 1 11 51 47 47 48 1 1 1 1 1 1 1 1 1 1 1 1 1 11 1 1 1 1 1 1 1 1 1 1 1 1 1 1 1 1 1 1 1 1 1 
0 14 0 1 1 1 1 1 1 1 1 1 1 1 1 0 1 1 1 1 1 1 1 1 1 1 1 1 1 1 1 1 1 1 1 1 1 1 1 1 1 1 1 1 1 1 1 1 1 1 1 1 10 21 1 1 1 1 1 1 1 1 1 1 1 1 1 11 52 49 49 50 1 1 1 1 1 1 1 1 1 1 1 1 1 1 1 1 11 52 49 49 50 1 1 1 1 1 1 1 1 1 1 1 16 17 11 1 1 1 1 1 1 1 1 1 1 1 1 1 1 1 1 1 1 1 1 1 
0 14 14 1 1 1 1 1 1 1 1 1 1 1 1 0 1 1 1 1 1 1 1 1 1 1 1 1 1 1 1 1 1 1 1 1 1 1 1 1 1 1 1 1 1 1 1 1 1 1 1 1 11 1 1 1 1 1 1 1 1 1 1 1 1 1 1 11 53 47 47 47 48 1 1 1 1 1 54 55 54 55 54 55 1 1 1 1 11 53 47 47 47 48 1 1 1 1 1 1 1 1 1 1 1 26 10 1 1 1 1 1 1 1 1 1 1 1 1 1 1 1 1 1 1 1 1 1 
0 0 0 0 1 1 1 1 1 1 1 1 1 1 1 1 1 1 1 1 1 1 1 1 1 1 1 1 1 1 1 1 1 1 1 1 1 1 1 1 1 1 1 1 1 1 1 54 55 54 55 1 11 1 1 1 1 1 1 1 1 1 1 1 1 1 1 11 56 49 49 49 50 1 1 1 1 1 57 58 57 58 57 58 1 1 1 1 11 56 49 49 49 50 1 1 1 1 1 1 1 1 1 1 1 1 11 1 1 1 1 1 1 1 1 1 1 1 1 1 1 1 1 1 1 1 1 1 
0 0 0 0 0 1 1 1 1 1 1 1 1 1 1 1 1 1 1 1 1 1 1 1 1 1 1 1 1 1 1 1 1 1 1 1 1 1 1 1 1 1 59 60 60 60 61 57 58 57 58 62 63 64 1 1 1 1 1 1 1 1 1 1 1 1 1 11 1 51 47 47 47 28 24 24 24 24 24 24 24 24 24 24 24 24 30 1 11 1 51 47 47 47 48 1 1 1 1 1 1 1 1 1 1 1 11 1 1 1 1 1 1 1 1 1 1 1 1 1 1 1 1 1 1 1 1 1 
0 0 0 0 0 0 0 0 0 0 0 0 0 1 1 1 1 1 1 1 1 1 1 1 1 1 1 1 1 1 1 1 1 1 1 1 1 1 1 1 1 1 1 65 66 67 59 60 60 60 60 60 60 60 61 1 1 1 1 1 1 1 1 1 1 1 1 11 1 52 49 49 49 28 24 24 24 24 24 24 24 24 24 24 24 24 30 1 11 1 52 49 49 49 50 1 1 1 1 1 1 1 1 1 1 62 63 64 1 1 1 1 1 1 1 1 1 1 1 1 1 1 1 1 1 1 1 1 
1 1 1 1 1 1 1 1 1 1 1 1 1 1 1 1 1 1 1 1 1 1 1 1 1 1 1 1 1 1 1 1 1 1 1 1 1 1 1 1 1 1 1 68 69 69 67 66 67 67 66 67 67 66 70 71 1 1 1 1 1 1 1 1 1 1 1 11 1 53 47 47 47 28 24 24 24 24 24 24 24 24 24 24 24 24 30 1 11 1 53 47 47 47 47 48 1 1 1 1 1 1 1 1 59 60 60 60 60 60 60 60 60 60 61 72 72 73 24 24 24 24 24 24 24 24 30 1 
1 1 1 1 1 1 1 1 1 1 1 1 1 1 1 1 1 1 1 1 1 1 1 1 1 1 1 1 1 1 1 1 1 1 1 1 1 1 1 1 1 59 60 61 69 69 69 69 69 69 69 69 69 69 69 74 71 1 1 1 1 1 1 1 1 1 62 63 64 56 49 49 49 14 14 13 13 75 22 24 24 25 12 13 13 14 14 62 63 64 56 49 49 49 49 50 1 1 1 1 1 1 1 76 77 66 67 67 66 67 67 66 78 79 14 80 81 1 1 1 1 1 1 1 1 1 1 1 
1 1 1 1 1 1 1 1 1 1 1 1 1 1 1 1 1 1 1 1 1 1 1 1 1 1 1 1 1 1 1 1 1 1 1 1 1 1 1 1 1 1 1 82 83 83 83 83 83 83 83 83 83 83 83 83 59 60 60 60 60 60 60 60 60 60 60 60 60 60 60 60 60 60 60 60 60 60 60 60 60 60 60 60 60 60 60 60 60 60 60 60 60 60 60 60 61 1 1 1 1 1 76 84 69 69 69 69 69 69 69 69 85 86 14 87 1 1 1 1 1 1 1 1 1 1 1 1 
1 1 1 1 1 1 1 1 1 1 1 1 1 1 1 1 1 1 1 1 1 1 1 1 1 1 1 1 1 1 1 1 1 1 1 1 1 1 1 1 1 1 1 1 1 1 65 67 67 67 67 67 67 67 67 67 67 66 67 67 66 67 67 66 67 67 66 67 67 66 67 67 66 67 67 66 67 67 66 67 67 66 67 67 66 67 67 66 67 67 66 67 67 66 67 67 70 88 16 17 88 88 84 69 69 69 69 69 69 69 69 69 89 90 91 1 1 1 1 1 1 1 1 1 1 1 1 1 
1 1 1 1 1 1 1 1 1 1 1 1 1 1 1 1 1 1 1 1 1 1 1 1 1 1 1 1 1 1 1 1 1 1 1 1 1 1 1 1 1 1 1 1 1 1 68 69 69 69 69 69 69 69 69 69 69 69 69 69 69 69 69 69 69 69 69 69 69 69 69 69 69 69 69 69 69 69 69 69 69 69 69 69 69 69 69 69 69 69 69 69 69 69 69 69 69 69 67 67 69 69 69 69 69 69 69 69 69 69 69 92 93 14 87 1 1 1 1 1 1 1 1 1 1 1 1 1 
1 1 1 1 1 1 1 1 1 1 1 1 1 1 1 1 1 1 1 1 1 1 1 1 1 1 1 1 1 1 1 1 1 1 1 1 1 1 1 1 1 1 1 1 1 1 68 69 69 69 69 69 69 69 69 69 69 69 69 69 69 69 69 69 69 69 69 69 69 69 69 69 69 69 69 69 69 69 69 69 69 69 69 69 69 69 69 69 69 69 69 69 69 69 69 69 69 69 69 69 69 69 69 69 69 69 69 69 69 69 69 89 90 94 1 1 1 1 1 1 1 1 1 1 1 1 1 1 
1 1 1 1 1 1 1 1 1 1 1 1 1 1 1 1 1 1 1 1 1 1 1 1 1 1 1 1 1 1 1 1 1 1 1 1 1 1 1 1 1 1 1 1 1 1 95 83 83 96 83 83 83 83 83 97 98 98 99 83 97 98 98 99 83 97 98 98 99 83 97 98 98 99 83 97 98 98 99 83 97 98 98 99 83 97 98 98 99 83 97 98 98 99 83 97 98 98 99 83 83 0 83 83 83 83 83 83 83 83 83 100 94 1 1 1 1 1 1 1 1 1 1 1 1 1 1 1 
1 1 1 1 1 1 1 1 1 1 1 1 1 1 1 1 1 1 1 1 1 1 1 1 1 1 1 1 1 1 1 1 1 1 1 1 1 1 1 1 1 1 1 1 1 1 1 1 1 68 69 69 69 69 69 101 14 14 68 69 101 14 14 68 69 101 14 14 68 69 101 14 14 68 69 101 14 14 68 69 101 14 14 68 69 101 14 14 68 69 101 14 14 68 69 101 14 14 68 69 69 67 69 69 69 69 69 69 69 69 89 102 1 1 1 1 1 1 1 1 1 1 1 1 1 1 1 1 
1 1 1 1 1 1 1 1 1 1 1 1 1 1 1 1 1 1 1 1 1 1 1 1 1 1 1 1 1 1 1 1 1 1 1 1 1 1 1 1 1 1 1 1 1 1 1 1 1 68 69 69 69 69 69 101 14 14 68 69 101 14 14 68 69 101 14 14 68 69 101 14 14 68 69 101 14 14 68 69 101 14 14 68 69 101 14 14 68 69 101 14 14 68 69 101 14 14 68 69 69 69 69 69 69 69 69 69 69 92 103 1 1 1 1 1 1 1 1 1 1 1 1 1 1 1 1 1 
1 1 1 1 1 1 1 1 1 1 1 1 104 105 106 107 108 1 1 1 1 1 1 1 1 1 1 1 1 1 1 1 1 1 1 1 1 1 1 1 1 1 1 1 1 1 1 1 1 95 83 83 83 83 83 109 110 110 111 83 109 110 110 111 83 109 110 110 111 83 109 110 110 111 83 109 110 110 111 83 109 110 110 111 83 109 110 110 111 83 109 110 110 111 83 109 110 110 111 83 83 83 0 83 83 83 83 83 83 112 113 1 1 1 1 1 1 1 1 1 1 1 1 1 1 1 1 1 
1 1 1 1 1 1 1 1 1 1 1 114 115 1 1 1 1 1 1 1 1 1 1 1 1 1 116 117 104 114 115 1 1 1 1 1 1 1 1 1 1 1 1 1 1 1 1 1 1 1 1 1 118 119 67 67 67 67 67 67 67 67 67 67 67 67 67 67 67 67 67 67 67 67 67 67 67 67 67 67 67 67 67 67 67 67 67 67 67 67 67 67 67 67 67 67 67 67 67 67 67 67 120 67 67 67 67 67 121 103 1 1 1 1 1 1 1 1 1 1 1 1 1 1 1 1 1 1 
114 115 108 1 1 1 1 1 1 1 1 1 1 1 1 1 1 1 1 1 1 1 1 1 1 1 122 123 1 1 1 1 1 1 1 1 1 1 1 1 1 1 1 104 114 115 108 1 1 1 1 1 124 125 126 126 126 126 126 126 126 126 126 126 126 126 126 126 126 126 126 126 126 126 126 126 126 126 126 126 126 126 126 126 126 126 126 126 126 126 126 126 126 126 126 126 126 126 126 126 126 126 126 126 126 126 126 126 89 113 1 1 1 1 1 1 1 1 1 1 1 1 1 104 108 104 1 1 
127 128 116 129 130 129 130 117 127 128 116 117 127 131 116 117 127 128 116 129 130 129 130 117 132 128 133 134 127 131 135 128 127 128 127 128 127 136 137 131 127 138 127 128 127 128 127 128 127 131 127 128 139 140 126 126 126 126 126 126 126 126 126 126 126 126 126 126 126 126 126 126 126 126 126 126 126 126 126 126 126 126 126 126 126 126 126 126 126 126 126 126 126 126 126 126 126 126 126 126 126 126 126 16 17 126 126 141 142 128 127 128 127 128 127 128 127 128 127 128 127 131 143 128 127 128 127 128 
144 144 122 145 146 145 146 123 144 147 122 123 144 144 122 123 144 144 122 145 146 145 146 123 144 144 122 123 144 144 148 144 144 144 144 144 144 144 144 149 150 33 151 144 144 144 144 144 144 144 144 152 153 140 154 154 154 154 154 154 154 154 154 154 154 154 154 154 154 154 154 154 154 154 154 154 154 154 154 154 154 154 154 154 154 154 154 154 154 154 154 154 154 154 154 154 154 154 154 154 154 154 154 155 155 154 156 157 144 116 129 130 129 130 129 130 117 144 144 144 149 150 33 151 144 144 144 144 
158 158 133 159 160 159 160 134 158 161 133 134 162 158 133 134 161 158 133 159 160 159 160 134 158 158 133 134 163 158 164 162 161 158 158 163 161 158 162 33 33 33 33 150 165 147 166 144 144 144 167 168 168 140 169 169 169 169 169 169 169 169 169 169 169 169 169 169 169 169 169 169 169 169 169 169 169 169 169 169 169 169 169 169 169 169 169 169 169 169 169 169 169 169 169 169 169 169 169 169 169 169 169 169 169 170 171 144 144 122 145 146 145 146 145 146 123 144 149 158 33 33 33 33 158 163 158 158 
172 173 174 175 176 177 174 175 172 173 174 175 172 173 174 175 172 173 174 175 176 177 174 175 172 173 174 175 172 173 174 178 172 173 179 178 172 173 179 178 172 173 179 178 172 173 179 178 172 173 179 175 176 177 174 175 176 177 174 175 176 177 174 175 176 177 174 175 176 177 174 175 176 177 174 175 176 177 174 175 176 177 174 175 176 177 174 175 176 177 174 175 176 177 174 175 176 177 174 175 176 177 174 175 176 177 179 178 172 177 174 175 176 177 174 175 176 173 179 178 172 173 179 178 172 173 179 178 
180 180 180 180 180 180 180 180 180 180 180 180 180 180 180 180 180 180 180 180 180 180 180 180 181 181 181 181 181 181 181 181 181 181 181 181 181 181 181 181 181 181 181 181 181 181 181 181 181 181 181 181 181 181 181 181 83 83 83 83 83 83 83 83 83 83 83 83 83 83 83 83 83 83 83 83 182 183 184 83 83 182 183 184 83 83 83 83 83 83 83 83 83 83 83 83 83 83 83 83 83 83 83 83 83 83 83 83 83 83 83 83 14 14 14 14 14 14 14 14 14 14 14 14 14 14 14 14 
180 181 181 181 181 181 181 181 181 181 181 181 181 181 181 181 181 181 181 181 181 181 181 180 181 181 181 181 181 181 181 181 181 181 181 181 181 181 181 181 181 181 181 181 181 181 181 181 181 181 181 181 181 181 181 181 83 83 83 83 83 83 83 83 185 186 186 186 186 186 186 186 186 186 186 187 182 183 184 83 83 182 183 184 185 186 186 186 186 186 186 186 186 186 186 187 83 83 83 83 83 83 83 83 83 83 83 83 83 83 83 83 14 14 14 14 14 14 14 14 14 14 14 14 14 14 14 14 
180 181 181 181 181 181 181 181 181 181 181 181 181 181 181 181 181 181 181 181 181 181 181 180 181 181 181 181 181 181 181 181 181 181 181 181 181 181 181 181 181 181 181 181 181 181 181 181 181 181 181 181 181 181 181 181 83 83 83 83 83 83 83 83 182 188 188 188 188 189 188 188 188 188 189 184 182 183 184 83 83 182 183 184 182 188 188 188 188 189 188 188 188 188 189 184 83 83 83 83 83 83 83 83 83 83 83 83 83 83 83 83 14 14 14 14 14 14 14 14 14 14 14 14 14 14 14 14 
180 181 181 181 181 181 181 181 181 181 181 181 181 181 181 181 181 181 181 181 181 181 181 180 181 181 181 181 181 181 181 181 181 181 181 181 181 181 181 181 181 181 181 181 181 181 181 181 181 181 181 181 181 181 181 181 83 83 83 83 83 83 83 83 182 190 190 190 190 191 190 190 190 190 191 192 193 14 184 83 83 182 14 192 193 190 190 190 190 191 190 190 190 190 191 184 83 83 83 83 83 83 83 83 83 83 83 83 83 83 83 83 14 14 14 14 14 14 14 14 14 14 14 14 14 14 14 14 
180 181 180 181 181 181 181 181 181 181 181 181 181 181 181 181 181 181 181 181 181 181 181 180 181 181 181 181 181 181 181 181 181 181 181 181 181 181 181 181 181 181 181 181 181 181 181 181 181 181 181 181 181 181 181 181 83 83 83 83 83 83 83 83 182 194 1 1 194 195 194 1 1 194 195 14 14 14 184 83 83 182 14 14 14 194 1 1 194 195 194 1 1 194 195 184 83 83 83 83 83 83 83 83 83 83 83 83 83 83 83 83 14 14 14 14 14 14 14 14 14 14 14 14 14 14 14 14 
180 181 181 181 181 180 181 181 181 181 181 181 181 181 181 181 181 181 181 181 181 181 181 180 181 181 181 181 181 181 181 181 181 181 181 181 181 181 181 181 181 181 181 181 181 181 181 181 181 181 181 181 181 181 181 181 83 83 83 83 83 83 83 83 182 194 1 1 194 195 194 1 1 194 196 197 197 197 198 83 83 199 197 197 197 200 1 1 194 195 194 1 1 194 195 184 83 83 83 83 83 83 83 83 83 83 83 83 83 83 83 83 14 14 14 14 14 14 14 14 14 14 14 14 14 14 14 14 
180 181 181 181 181 181 181 181 180 181 181 181 181 181 181 181 181 181 181 181 181 181 181 180 181 181 181 181 181 181 181 181 181 181 181 181 181 181 181 181 181 181 181 181 181 181 181 181 181 181 181 181 181 181 181 181 83 83 83 83 83 83 83 83 182 190 190 190 190 191 190 190 180 190 192 186 186 186 186 186 186 186 186 186 186 193 190 190 190 191 190 197 197 197 197 198 83 83 83 83 83 83 83 83 83 83 83 83 83 83 83 83 14 14 14 14 14 14 14 14 14 14 14 14 14 14 14 14 
180 181 181 181 181 181 181 181 181 181 181 180 181 181 181 181 181 181 181 181 181 181 181 180 181 181 181 181 181 181 181 181 181 181 181 181 181 181 181 181 181 181 181 181 181 181 181 181 181 181 181 181 181 181 181 181 83 83 83 83 83 83 83 83 182 194 194 194 194 195 194 194 188 194 189 188 188 188 188 189 188 188 188 188 189 188 194 194 194 195 197 83 83 83 83 83 83 83 83 83 83 83 83 83 83 83 83 83 83 83 83 83 14 14 14 14 14 14 14 14 14 14 14 14 14 14 14 14 
180 181 181 181 181 181 181 181 181 181 181 181 181 181 180 181 181 181 181 181 181 181 181 180 181 181 181 181 181 181 181 181 181 181 181 181 181 181 181 181 181 181 181 181 181 181 181 181 181 181 181 181 181 181 181 181 83 83 83 83 83 83 83 83 182 201 202 201 202 201 202 194 194 194 195 194 194 194 194 195 194 194 194 194 195 194 194 194 194 197 83 83 83 83 83 83 83 83 83 83 83 83 83 83 83 83 83 83 83 83 83 83 14 14 14 14 14 14 14 14 14 14 14 14 14 14 14 14 
180 181 181 181 181 181 181 181 181 181 181 181 181 181 181 181 181 181 181 181 181 181 181 180 181 181 181 181 181 181 181 181 181 181 181 181 181 181 181 181 181 181 181 181 181 181 181 181 181 181 181 181 181 181 181 181 83 83 83 83 83 83 83 83 182 203 204 203 204 203 204 194 194 194 195 194 194 194 194 195 194 194 194 194 195 194 194 194 197 83 83 83 83 83 83 83 83 83 83 83 83 83 83 83 83 83 83 83 83 83 83 83 14 14 14 14 14 14 14 14 14 14 14 14 14 14 14 14 
180 181 181 181 181 181 181 181 181 181 181 181 181 181 181 181 181 181 181 181 181 181 181 180 181 181 181 181 181 181 181 181 181 181 181 181 181 181 181 181 181 181 181 181 181 181 181 181 181 181 181 181 181 181 181 181 83 83 83 83 83 83 83 83 199 197 197 197 197 197 197 197 197 197 197 197 197 197 197 197 197 197 197 197 197 197 197 197 83 83 83 83 83 83 83 83 83 83 83 83 83 83 83 83 83 83 83 83 83 83 83 83 14 14 14 14 14 14 14 14 14 14 14 14 14 14 14 14 
180 180 180 180 180 180 180 180 180 180 180 180 180 180 180 180 181 181 181 180 180 180 180 180 181 181 181 181 181 181 181 181 181 181 181 181 181 181 181 181 181 181 181 181 181 181 181 181 181 181 181 181 181 181 181 181 83 83 83 83 83 83 83 83 83 83 83 83 83 83 83 83 83 83 83 83 83 83 83 83 83 83 83 83 83 83 83 83 83 83 83 83 83 83 83 83 83 83 83 83 83 83 83 83 83 83 83 83 83 83 83 83 14 14 14 14 14 14 14 14 14 14 14 14 14 14 14 14 
