24 64 8 9 72
0 1 1 1 1 1 1 1 1 1 2 3 3 3 3 3 3 3 3 3 3 3 3 3 3 3 3 3 3 3 3 3 3 3 3 3 3 3 3 3 3 3 3 3 3 3 3 3 3 3 3 3 3 3 3 3 3 3 3 3 3 3 3 4 
5 6 7 8 9 6 7 8 9 3 3 3 3 3 3 3 3 3 3 3 3 3 3 3 3 3 3 3 3 3 3 3 3 3 3 3 3 3 3 3 3 3 3 3 3 3 3 3 3 3 3 3 3 3 3 3 3 3 3 3 3 3 3 4 
5 10 11 12 13 10 11 12 13 3 3 3 3 3 3 3 3 3 3 3 3 3 3 3 3 3 3 3 3 3 3 3 3 3 3 3 3 3 3 3 3 3 3 3 3 3 3 3 3 3 3 3 3 3 3 3 3 3 3 3 3 3 3 4 
5 14 15 16 17 14 15 16 17 3 3 3 3 3 3 3 3 3 3 3 3 3 3 3 3 3 3 3 3 3 3 3 3 3 3 3 3 3 3 3 3 3 3 3 3 3 3 3 3 3 3 3 3 3 3 3 3 3 3 3 3 3 3 4 
5 12 13 10 11 12 13 10 11 3 3 3 3 3 3 3 3 3 3 3 3 3 3 3 3 3 3 3 3 3 3 3 3 3 3 3 3 3 3 3 3 3 3 3 3 3 3 3 3 3 3 3 3 3 3 3 3 3 3 3 3 3 3 4 
5 16 17 14 15 16 17 14 15 3 3 3 3 3 3 3 3 3 3 3 3 3 3 3 3 3 3 3 3 3 3 3 3 3 3 3 3 3 3 3 3 3 3 3 3 3 3 3 3 3 3 3 3 3 3 3 3 3 3 3 3 3 3 4 
5 10 11 12 13 10 11 12 13 3 3 3 3 3 3 3 3 3 3 3 3 3 3 3 3 3 3 3 3 3 3 3 3 3 3 18 3 3 3 3 3 3 3 3 3 3 3 3 3 3 3 3 3 3 3 3 3 3 3 3 3 3 3 4 
5 14 15 19 20 20 21 16 17 3 3 3 3 3 3 3 3 3 3 3 3 3 3 3 3 3 3 3 3 3 3 3 3 3 3 3 3 3 3 3 3 3 3 3 3 3 3 3 3 3 3 3 3 3 3 3 3 3 3 3 3 3 3 4 
5 12 13 4 0 0 5 10 11 3 3 3 3 3 3 3 3 3 3 3 3 3 3 3 3 3 3 3 3 3 3 3 3 3 3 3 3 3 3 3 3 3 3 3 3 3 3 3 3 3 3 3 3 3 3 3 3 3 3 3 3 3 3 4 
22 20 20 23 0 0 22 20 20 20 21 3 3 3 3 3 3 3 3 3 3 3 3 3 3 3 3 3 3 3 3 3 3 3 3 3 3 3 18 3 3 3 3 24 25 3 3 3 18 3 3 3 18 3 3 3 18 3 3 3 3 3 3 4 
0 1 1 1 1 1 1 1 1 1 2 3 3 3 3 3 3 3 3 3 3 3 3 3 3 3 3 3 3 3 3 3 3 3 3 3 3 3 3 3 3 3 3 3 3 3 3 3 3 3 3 3 3 3 3 3 3 3 3 3 3 3 3 4 
5 3 3 3 3 3 3 3 3 3 3 3 3 3 3 3 3 3 3 3 3 3 3 3 3 3 3 3 3 3 3 3 3 3 3 3 3 3 3 3 3 3 3 3 3 3 3 3 3 3 3 3 3 3 3 3 3 3 3 24 25 3 3 4 
5 3 3 3 3 3 3 3 3 3 3 3 3 3 3 3 3 3 3 3 3 3 3 3 3 3 3 3 3 3 3 3 3 3 3 3 3 3 3 3 3 3 3 3 3 3 3 3 3 3 3 3 3 3 3 3 3 3 3 3 3 3 3 4 
5 3 3 3 3 3 3 3 3 3 3 3 3 3 3 3 3 3 3 3 3 3 3 3 3 3 3 3 3 3 3 3 3 3 3 3 3 3 3 3 3 3 3 3 3 3 3 3 3 3 3 3 3 3 3 3 3 3 3 3 3 3 3 4 
5 3 3 3 3 3 3 3 3 3 3 3 3 3 16 17 14 15 16 17 3 3 16 17 14 15 16 17 3 3 3 3 3 3 3 3 3 3 3 3 3 3 3 3 3 3 3 3 3 3 3 3 3 3 3 3 3 3 3 3 3 3 3 4 
5 3 3 3 3 3 3 3 3 3 3 3 3 3 10 11 12 13 10 11 3 3 10 11 12 13 10 11 3 3 3 3 3 3 3 3 3 3 3 3 3 3 3 3 3 3 3 3 3 3 3 3 3 3 3 3 3 3 3 3 3 3 24 0 
5 3 3 3 3 3 3 3 3 3 3 3 3 3 14 15 16 17 14 15 3 3 14 15 16 17 14 15 3 3 3 3 3 3 3 3 3 3 3 3 3 3 3 3 3 26 27 28 3 3 3 3 3 3 3 3 3 15 16 17 14 15 6 4 
5 3 3 3 3 3 3 3 3 3 3 3 3 3 12 13 18 29 29 18 3 3 18 30 30 18 12 13 3 3 3 3 3 3 3 3 3 26 31 32 33 34 35 36 37 38 36 38 36 38 36 38 39 38 40 41 38 13 10 11 12 13 10 4 
5 3 3 3 27 28 3 3 3 3 3 3 3 3 16 17 8 9 6 7 34 3 6 7 8 9 16 17 26 35 42 43 38 36 39 37 38 36 38 36 44 45 46 46 46 46 46 46 46 46 47 48 49 50 51 19 21 17 14 15 16 17 14 4 
5 36 38 36 38 36 38 39 38 36 40 41 37 36 10 11 12 13 10 11 38 37 10 11 12 13 18 11 45 46 46 46 47 48 49 50 46 46 47 48 49 50 51 52 46 46 46 47 53 54 49 49 49 49 54 4 5 11 12 19 20 20 20 23 
5 46 46 51 52 47 48 49 50 46 46 46 46 46 14 15 16 17 19 20 20 20 20 21 16 17 8 15 46 46 47 54 49 49 49 49 54 53 49 49 49 49 54 54 55 54 53 49 49 49 49 49 56 57 20 23 5 15 16 58 1 1 1 0 
5 54 55 54 54 49 49 49 49 54 53 54 54 19 21 13 10 11 4 0 0 0 0 5 10 11 12 13 53 55 56 57 20 20 59 60 49 49 56 57 20 20 59 60 49 49 49 49 49 49 56 61 62 0 0 0 5 13 10 63 63 64 65 4 
22 20 20 20 20 20 20 20 20 20 20 20 20 23 22 20 20 20 23 0 0 0 0 22 21 30 30 30 30 19 66 0 0 0 0 67 20 20 66 0 0 0 0 67 21 30 30 30 30 19 66 0 0 0 0 0 22 20 20 20 20 21 68 4 
0 0 0 0 0 0 0 0 0 0 0 0 0 0 0 0 0 0 0 0 0 0 0 0 0 69 69 69 69 0 0 0 0 0 0 0 0 0 0 0 0 0 0 0 0 69 69 69 69 0 0 0 0 0 0 0 0 0 0 0 0 5 68 4 
