48 128 25 27 675
0 0 0 0 0 0 0 0 0 0 0 0 0 0 0 0 0 0 0 0 0 0 0 1 2 2 2 2 2 2 2 2 2 2 2 2 2 2 2 2 2 2 2 2 2 2 2 2 2 2 2 2 2 2 2 2 2 2 2 2 2 2 2 2 2 2 2 2 2 2 2 2 2 2 2 2 2 2 2 2 2 2 2 2 2 2 2 2 2 2 2 2 2 3 0 0 0 0 0 0 0 0 0 0 0 0 0 0 0 0 0 0 0 0 0 0 0 0 0 0 0 0 0 0 0 0 0 4 
5 5 5 5 5 5 5 5 6 7 8 9 5 5 6 7 8 9 5 5 5 5 10 11 12 12 12 12 12 12 12 12 12 12 12 12 12 12 12 12 12 12 12 12 12 12 12 12 12 12 12 12 12 12 12 12 12 12 12 12 12 12 12 12 12 12 12 12 12 12 12 12 12 12 12 12 12 12 12 12 12 12 12 12 12 12 12 12 12 12 12 12 12 13 14 6 7 15 5 5 5 5 5 5 5 5 5 5 5 5 5 5 5 5 5 5 5 5 5 5 5 5 5 5 5 5 5 16 
17 17 17 17 17 17 17 17 18 19 20 21 17 17 18 19 20 21 17 17 17 17 22 12 12 12 12 12 12 12 12 12 12 12 12 12 12 12 12 12 12 12 12 12 12 12 12 12 12 12 12 12 12 12 12 12 12 12 12 12 12 12 12 12 12 12 12 12 12 12 12 12 12 12 12 12 12 12 12 12 12 12 12 12 12 12 12 12 12 12 12 12 12 12 23 18 19 24 25 25 25 25 25 25 25 25 25 25 25 25 25 25 26 27 26 27 26 27 26 27 26 27 26 27 26 27 26 28 
12 12 12 12 12 12 12 12 29 19 30 12 12 12 29 19 30 12 12 12 12 12 12 12 12 12 12 12 12 12 12 12 12 12 12 12 12 12 12 12 12 12 12 12 12 12 12 12 12 12 12 12 12 12 12 12 12 12 12 12 12 12 12 12 12 12 12 12 12 12 12 12 12 12 12 12 12 12 12 12 12 12 12 12 12 12 12 12 12 12 12 12 12 12 12 29 19 31 32 32 32 32 32 32 32 32 32 32 32 32 32 32 33 34 35 34 35 34 35 34 35 34 35 34 35 34 35 36 
12 12 12 12 12 12 12 12 29 19 30 12 12 12 29 19 30 12 12 12 12 12 12 12 12 12 12 12 12 12 12 12 12 12 12 12 12 12 12 12 12 12 12 12 12 12 12 12 12 12 12 12 12 12 12 12 12 12 12 12 12 12 12 12 12 12 12 12 12 12 12 12 12 12 12 12 12 12 12 12 12 12 12 12 12 12 12 12 12 12 12 12 12 12 12 29 19 31 32 32 32 32 32 32 32 32 32 32 32 32 32 32 37 38 39 38 39 40 34 35 34 35 34 35 34 35 34 41 
12 12 12 12 12 12 12 12 29 19 30 12 12 12 29 19 30 12 12 12 12 12 12 12 12 12 12 12 12 12 12 12 12 12 12 12 12 12 12 12 12 12 12 12 12 12 12 12 12 12 12 12 12 12 12 12 12 12 12 12 12 12 12 12 12 12 12 12 12 12 12 12 12 12 12 12 12 12 12 12 12 12 12 12 12 12 12 12 12 12 12 12 12 12 12 29 19 31 32 32 32 32 32 32 32 32 32 32 32 32 32 32 42 43 44 45 46 45 35 34 35 34 35 34 47 48 49 50 
12 12 12 12 12 12 12 12 29 19 30 12 12 12 29 19 30 12 12 12 12 12 12 12 12 12 12 12 12 12 12 12 12 12 12 12 12 12 12 12 12 12 12 12 12 12 12 12 12 12 12 12 12 12 12 12 12 12 12 12 12 12 12 12 12 12 12 12 12 12 12 12 12 12 51 52 53 12 12 12 12 12 12 12 12 54 55 56 57 12 12 12 12 12 12 29 19 31 32 32 58 59 60 32 32 32 58 59 60 32 32 32 61 62 63 40 34 35 64 65 66 40 34 35 67 68 69 70 
12 12 12 12 12 12 12 12 29 19 30 12 12 12 29 19 30 12 12 12 12 12 12 12 12 12 12 12 71 72 73 72 73 72 73 72 73 72 73 72 73 72 73 72 73 72 73 72 73 72 73 72 73 74 12 12 12 12 12 12 12 12 12 12 12 12 12 12 12 12 12 12 12 75 76 77 78 12 12 12 12 12 12 12 79 80 81 82 83 12 12 12 12 12 12 29 19 31 32 32 84 12 85 32 32 32 84 12 85 32 32 32 86 12 87 43 33 34 88 12 85 45 89 90 91 90 92 36 
12 12 12 12 12 12 12 12 29 19 30 12 12 12 29 19 30 12 12 12 12 12 12 12 12 12 12 71 93 94 95 96 97 98 99 96 97 98 99 96 97 98 99 96 97 98 99 96 97 98 99 96 95 100 74 12 12 12 12 12 12 12 12 12 12 12 12 12 12 12 12 12 12 101 102 103 104 12 12 12 12 105 106 107 80 108 109 110 111 72 112 12 12 12 12 29 19 31 32 32 84 12 85 32 32 32 84 12 85 32 32 113 114 12 115 116 117 35 118 12 115 40 119 120 121 122 123 41 
12 12 12 12 12 12 12 12 29 19 30 12 12 12 29 19 30 12 12 12 12 12 12 12 12 12 71 93 124 125 126 127 128 129 130 127 128 129 130 127 128 129 130 127 128 129 130 127 128 129 130 127 131 132 133 74 12 12 12 12 12 12 12 12 12 12 12 12 12 12 12 134 135 136 137 138 139 12 12 12 12 140 141 142 143 144 99 145 146 94 100 74 12 12 12 29 19 31 32 32 84 12 85 32 32 32 84 12 85 32 32 32 147 12 87 43 148 149 150 12 85 45 35 34 35 34 35 36 
12 12 12 71 72 73 72 73 151 152 153 73 72 73 151 152 153 73 72 73 72 73 72 73 72 73 93 124 125 154 155 156 157 158 155 156 157 158 155 156 157 158 155 156 157 158 155 156 157 158 155 156 157 159 132 133 72 112 12 12 71 160 161 12 12 71 160 161 12 12 71 162 163 164 164 165 166 161 12 71 72 167 110 168 169 124 125 170 171 172 132 133 72 73 72 173 174 175 176 177 178 73 179 177 176 177 178 73 179 177 176 177 178 73 179 180 181 180 182 73 179 183 184 185 186 187 188 189 
72 73 72 190 191 99 145 146 94 95 145 146 94 95 145 146 94 95 145 146 94 95 145 146 94 95 192 125 193 194 195 12 196 197 195 12 196 197 195 12 196 197 195 12 196 197 195 12 196 197 195 12 198 199 193 132 200 201 202 202 203 204 205 202 202 203 204 205 202 202 203 204 206 206 207 208 209 205 202 210 200 97 98 99 192 125 154 155 156 157 159 132 211 146 94 95 145 146 94 95 145 146 94 95 145 146 94 95 145 146 94 95 145 146 94 95 145 146 94 95 145 146 94 95 145 146 94 212 
213 214 213 215 216 217 218 219 217 220 218 219 217 220 218 219 217 220 218 219 217 221 222 223 224 225 225 225 225 226 227 12 228 229 227 12 228 229 227 12 228 229 227 12 228 229 227 12 228 229 227 12 230 231 225 225 225 232 233 233 233 233 234 235 236 236 236 236 236 236 236 236 236 236 236 237 238 236 236 239 240 241 242 243 240 240 244 245 246 247 248 240 241 242 243 240 241 242 243 240 241 242 243 240 241 242 243 240 241 242 243 240 241 242 243 240 241 242 243 240 241 242 243 240 241 242 243 249 
12 12 12 13 14 5 5 5 6 7 8 9 5 5 6 7 8 9 5 5 10 11 12 12 12 12 12 12 12 12 12 12 12 12 12 12 12 12 12 12 12 12 12 12 12 12 12 12 12 12 12 12 12 12 12 12 12 12 12 12 12 12 85 250 32 32 32 32 32 32 32 32 32 32 32 32 32 32 32 32 32 32 32 32 32 32 32 32 32 32 32 32 32 32 32 32 32 32 32 32 32 32 32 32 32 32 32 32 32 32 32 32 32 32 32 32 32 32 32 32 32 32 32 32 32 32 32 32 
251 252 253 12 23 17 17 17 18 19 20 21 17 17 18 19 20 21 17 17 22 12 12 12 12 12 12 12 12 12 12 12 12 12 12 12 12 12 12 12 12 12 12 12 12 12 12 12 134 252 253 12 12 12 12 12 12 12 12 12 12 12 85 250 32 32 32 32 32 32 32 32 32 32 32 32 32 32 32 32 32 32 32 32 32 32 32 32 32 32 32 32 32 32 32 32 32 32 32 32 32 32 32 32 32 32 32 32 32 32 32 32 32 32 32 32 32 32 32 32 32 32 32 32 32 32 32 32 
254 255 256 12 12 12 12 12 29 19 30 12 12 12 29 19 30 12 12 12 12 12 12 12 12 12 12 12 134 252 253 12 12 12 12 12 12 12 12 12 12 12 12 12 12 12 12 12 257 258 259 12 12 12 12 12 12 12 12 12 12 12 85 250 32 32 32 32 32 32 32 32 32 32 32 32 32 32 32 32 32 32 32 32 32 32 32 32 32 32 32 32 32 32 32 32 32 32 32 32 32 32 32 32 32 32 32 32 32 32 32 32 32 32 32 32 32 32 32 32 32 32 32 32 32 32 32 32 
260 132 261 12 12 12 12 12 29 19 30 12 12 12 29 19 30 12 12 12 12 12 12 12 12 12 12 12 257 258 259 12 12 12 12 12 12 12 134 252 253 12 12 12 12 12 12 12 262 193 263 12 12 12 12 12 12 12 12 12 12 12 85 250 32 32 32 32 32 32 32 32 32 32 32 32 32 32 32 32 32 32 32 32 32 32 32 32 32 32 32 32 32 32 32 32 32 32 32 32 32 32 32 32 32 32 32 32 32 32 32 32 32 32 32 32 32 32 32 32 32 32 32 32 32 32 32 32 
260 193 264 252 253 12 12 12 29 19 30 12 12 12 29 19 30 12 12 12 12 12 12 12 12 12 12 12 265 266 259 12 12 12 12 12 12 12 265 266 259 12 12 12 12 12 12 12 262 193 259 12 12 12 12 12 12 12 12 12 12 12 85 250 32 32 32 32 32 32 32 32 32 32 32 32 32 32 32 32 32 32 32 32 32 32 32 32 32 32 32 32 32 32 32 32 32 32 32 32 32 32 32 32 32 32 32 32 32 32 32 32 32 32 32 32 32 32 32 32 32 32 32 32 32 32 32 32 
260 193 267 268 269 12 12 12 29 19 30 12 12 12 29 19 30 12 12 12 12 12 12 12 12 12 12 12 262 193 263 12 12 12 12 12 12 12 262 193 259 12 12 12 12 12 12 12 262 193 259 12 12 12 12 12 12 12 12 12 12 12 85 250 32 32 32 32 32 32 32 32 32 32 32 32 32 32 32 32 32 32 32 32 32 32 32 32 32 32 32 32 32 32 32 32 32 32 32 32 32 32 32 32 32 32 32 32 32 32 32 32 32 32 32 32 32 32 32 32 32 32 32 32 32 32 32 32 
270 193 271 272 273 12 12 12 29 19 30 12 12 12 29 19 30 12 12 12 12 12 12 12 12 12 12 12 262 193 259 12 12 12 12 12 12 12 262 193 263 12 12 12 12 12 12 12 265 266 274 12 12 12 12 12 12 12 12 12 12 12 85 250 32 32 32 32 32 32 32 32 32 32 32 32 32 32 32 32 32 32 32 32 32 32 32 32 32 32 32 32 32 32 32 32 32 32 32 32 32 32 32 32 32 32 32 32 32 32 32 32 32 32 32 32 32 32 32 32 32 32 32 32 32 32 32 32 
275 276 277 276 278 12 12 12 29 279 280 281 282 12 29 19 30 12 12 12 12 12 12 12 12 12 12 12 283 284 285 286 281 282 12 12 12 12 283 276 278 12 12 287 288 289 287 290 291 276 292 293 281 282 12 12 12 12 12 12 12 12 85 250 32 32 32 32 32 32 32 32 32 32 32 32 32 32 32 32 32 32 32 32 32 32 32 32 32 32 32 32 32 32 32 32 32 32 32 32 32 32 32 32 32 32 32 32 32 32 32 32 32 32 32 32 32 32 32 32 32 32 32 32 32 32 32 32 
294 295 296 295 297 298 298 298 299 300 301 302 297 298 299 303 304 298 298 305 12 12 12 12 12 306 307 298 299 308 301 309 302 297 298 298 298 298 299 295 297 298 298 310 301 297 310 301 311 295 312 313 302 297 298 298 298 305 12 12 12 12 85 250 32 32 32 32 32 32 32 32 32 32 32 32 32 32 32 32 32 32 32 32 32 32 32 32 32 32 32 32 32 32 32 32 32 32 32 32 32 32 32 32 32 32 32 32 32 32 32 32 32 32 32 32 32 32 32 32 32 32 32 32 32 32 32 32 
314 314 314 314 314 314 314 314 314 314 314 314 314 314 314 314 314 314 315 316 298 305 12 306 307 317 318 314 314 314 314 314 314 314 314 314 314 314 314 314 314 314 314 314 314 314 314 314 314 314 314 314 314 314 314 314 315 316 298 305 12 12 85 250 32 32 32 32 32 32 32 32 32 32 32 32 32 32 32 32 32 32 32 32 32 32 32 32 32 32 32 32 32 32 32 32 32 32 32 32 32 32 32 32 32 32 32 32 32 32 32 32 32 32 32 32 32 32 32 32 32 32 32 32 32 32 32 32 
319 319 319 319 319 319 319 319 319 319 319 319 319 319 319 319 319 319 319 320 314 321 202 210 322 314 323 319 319 319 319 319 319 319 319 319 319 319 319 319 319 319 319 319 319 319 319 319 319 319 319 319 319 319 319 319 319 320 314 324 12 71 179 325 32 32 32 32 32 32 32 32 32 32 32 32 32 32 32 32 32 32 32 32 32 32 32 32 32 32 32 32 32 32 32 32 32 32 32 32 32 32 32 32 32 32 32 32 32 32 32 32 32 32 32 32 32 32 32 32 32 32 32 32 32 32 32 32 
326 326 326 326 326 326 326 326 326 326 326 326 326 326 326 326 326 326 326 326 326 327 236 239 328 326 326 326 326 326 326 326 326 326 326 326 326 326 326 326 326 326 326 326 326 326 326 329 330 331 332 331 332 331 332 331 332 331 332 333 334 335 336 337 338 339 340 339 340 339 340 339 340 339 340 339 340 339 341 342 338 339 340 339 340 339 340 339 340 339 340 339 340 339 341 342 338 339 340 339 340 339 340 339 340 339 340 339 340 339 341 342 343 344 345 344 345 344 345 344 345 344 345 344 345 344 346 347 
32 32 32 32 32 32 32 32 32 32 32 32 32 32 32 32 32 32 32 32 32 32 32 32 32 32 32 32 32 32 32 32 32 32 32 32 32 32 32 32 32 32 32 32 32 32 32 348 349 350 351 350 351 350 351 350 351 350 351 352 353 354 355 356 357 358 359 360 361 358 359 360 361 358 359 360 361 358 362 363 357 358 359 360 361 358 359 360 361 358 359 360 361 358 362 363 357 358 359 360 361 358 359 360 361 358 359 360 361 358 362 363 364 365 351 350 351 350 351 350 351 350 351 350 351 350 366 367 
32 32 32 32 32 32 32 32 32 32 32 32 32 32 32 32 32 32 32 32 32 32 32 32 32 32 32 32 32 32 32 32 32 32 32 32 32 32 32 32 32 32 32 32 32 32 32 348 368 369 370 369 370 369 370 369 370 369 370 371 372 373 32 374 375 376 377 378 379 376 377 378 379 376 377 378 379 376 380 381 382 376 377 378 379 376 377 378 379 376 377 378 379 376 380 381 382 376 377 378 379 376 377 378 379 376 377 378 379 376 383 384 32 385 370 369 370 369 370 369 370 369 370 369 370 369 386 367 
32 32 32 32 32 32 32 32 32 32 32 32 32 32 32 32 32 32 32 32 32 32 32 32 32 32 32 32 32 32 32 32 32 32 32 32 32 32 32 32 32 32 32 32 32 32 32 348 387 388 353 388 353 388 353 388 353 388 353 354 389 354 32 84 390 391 392 393 394 391 392 393 394 391 392 393 394 391 392 393 394 391 392 393 394 391 392 393 394 391 392 393 394 391 392 393 394 391 392 393 394 391 392 393 394 391 392 393 394 391 395 396 32 397 353 388 353 388 353 388 353 388 353 388 353 388 398 367 
32 32 32 32 32 32 32 32 32 32 32 32 32 32 32 32 32 32 32 32 32 32 32 32 32 32 32 32 32 32 32 32 32 32 32 32 32 32 32 32 32 32 32 32 32 32 32 348 368 369 370 369 370 369 399 400 401 402 403 404 370 373 32 405 406 407 408 409 409 407 408 409 409 407 408 409 409 407 410 411 412 407 408 409 409 407 408 409 409 407 408 409 409 407 410 411 412 407 408 409 409 407 408 409 409 407 408 409 409 407 413 414 415 416 370 369 370 369 370 369 370 369 370 369 370 369 386 367 
32 32 32 32 32 32 32 32 32 32 32 32 32 32 32 32 32 32 32 32 32 32 32 32 32 32 32 32 32 32 32 32 32 32 32 32 32 32 32 32 32 32 32 32 32 32 32 348 387 388 353 388 353 388 417 418 419 420 421 422 353 354 423 424 349 425 351 425 351 425 351 425 351 425 351 425 351 425 366 426 349 425 351 425 351 425 351 425 351 425 351 425 351 425 366 426 349 425 351 425 351 425 351 425 351 425 351 425 351 425 366 426 427 428 429 388 353 388 353 388 353 388 353 388 353 388 398 367 
32 32 32 32 32 32 32 32 32 32 32 32 32 32 32 32 32 32 32 32 32 32 32 32 32 32 32 32 32 32 32 32 32 32 32 32 32 32 32 32 32 32 32 32 32 32 32 348 368 369 370 369 370 369 430 431 432 433 434 435 386 436 427 424 368 369 370 369 370 369 370 369 370 369 370 369 370 369 386 426 368 369 370 369 370 369 370 369 370 369 370 369 370 369 386 426 368 369 370 369 370 369 370 369 370 369 370 369 370 369 386 426 427 424 437 438 370 369 370 369 370 369 370 369 370 369 386 367 
32 32 32 32 32 32 32 32 32 32 32 32 32 32 32 32 32 32 32 32 32 32 32 32 32 32 32 32 32 32 32 32 32 32 32 32 32 32 32 32 32 32 32 32 32 32 32 348 387 388 353 388 353 388 439 352 353 354 389 388 398 426 427 424 387 388 353 388 353 388 353 388 353 388 353 388 353 388 398 426 387 388 353 388 353 388 353 388 353 388 353 388 353 388 398 426 387 388 353 388 353 388 353 388 353 388 353 388 353 388 398 426 427 424 427 428 429 388 353 388 398 440 441 442 441 442 443 444 
32 32 32 32 32 32 32 32 32 32 32 32 32 32 32 32 32 32 32 32 32 32 32 32 32 32 32 32 32 32 32 32 32 32 32 32 32 32 32 32 32 32 32 32 32 32 32 348 445 446 447 369 370 369 370 369 370 369 370 369 386 426 427 424 368 369 370 369 370 369 370 369 370 369 370 369 370 369 386 426 368 369 370 369 370 369 370 369 370 369 386 448 449 438 386 426 368 369 370 369 370 369 370 369 370 369 370 369 370 369 386 426 427 424 427 424 437 438 370 369 386 363 450 356 450 356 451 444 
32 32 32 32 32 32 32 32 32 32 32 32 32 32 32 32 32 32 32 32 32 32 32 32 32 32 32 32 32 32 32 32 32 32 32 32 32 32 32 32 32 32 32 32 32 32 32 348 452 453 454 388 353 388 353 388 353 388 353 388 398 426 427 424 387 388 455 442 441 456 353 388 353 457 458 459 460 388 398 426 387 388 455 442 429 388 398 440 429 388 398 426 427 461 398 426 387 388 455 442 441 456 353 388 353 388 353 388 455 456 398 426 427 424 427 424 427 428 429 388 398 365 32 462 463 464 465 367 
32 32 32 32 32 32 32 32 32 32 32 32 32 32 32 32 32 32 32 32 32 32 32 32 32 32 32 32 32 32 32 32 32 32 32 32 32 32 32 32 32 32 32 32 32 32 32 348 466 467 468 369 370 369 370 369 370 369 370 371 469 426 427 424 368 373 470 424 427 471 370 369 370 472 458 459 458 369 386 426 368 373 470 424 368 369 386 426 368 369 386 426 427 471 386 426 368 373 470 424 427 471 370 371 473 438 370 373 470 471 386 426 427 424 427 424 427 424 437 474 449 475 415 476 477 478 479 367 
32 32 32 32 32 32 32 32 32 32 32 32 32 32 32 32 32 32 32 32 32 32 32 32 32 32 32 32 32 32 32 32 32 32 32 32 32 32 32 32 32 32 32 32 32 32 32 348 427 424 480 481 482 481 482 481 482 481 482 483 484 426 427 424 480 485 486 487 486 488 482 481 482 481 482 481 482 481 489 426 480 485 486 487 486 481 482 487 486 481 482 487 486 488 489 426 480 485 486 487 486 488 482 485 486 488 482 485 486 488 489 426 427 424 427 424 427 424 427 424 427 424 427 424 427 490 491 367 
2 2 2 2 2 2 2 2 2 2 2 2 2 2 2 2 2 2 2 2 2 2 2 2 2 2 2 2 2 2 2 2 2 2 2 2 2 2 2 2 2 2 2 2 2 2 2 492 493 494 495 496 496 496 496 496 496 496 496 496 497 494 493 494 495 496 496 496 496 496 496 496 496 496 496 496 496 496 497 494 495 496 496 496 496 496 496 496 496 496 496 496 498 499 500 501 502 503 503 503 503 503 503 503 503 503 503 503 503 503 504 505 506 505 506 505 506 505 506 505 506 505 506 505 507 508 491 509 
12 12 12 12 12 12 12 12 12 12 12 12 12 12 12 12 12 12 12 12 12 12 12 12 12 12 12 12 12 12 12 12 12 12 12 12 12 12 12 12 12 12 12 12 12 12 12 12 12 12 12 12 12 12 12 12 12 12 12 12 12 12 12 12 12 12 12 12 12 12 12 12 12 12 12 12 12 12 12 12 12 12 12 12 12 12 12 12 12 12 12 12 510 511 512 513 9 5 5 5 6 7 8 9 5 5 5 5 6 7 8 9 5 5 5 5 6 7 8 9 5 5 5 5 514 515 491 250 
12 12 12 12 12 12 12 12 12 12 12 12 12 12 12 12 12 12 12 12 12 12 12 12 12 12 12 12 12 12 12 12 12 12 12 12 12 12 12 12 12 12 12 12 12 12 12 12 12 12 12 12 12 12 12 12 12 12 12 12 12 12 12 12 12 12 12 12 12 12 12 12 12 12 12 12 12 12 12 12 12 12 12 12 12 12 12 12 12 12 12 12 510 511 512 516 517 25 25 25 518 19 31 517 25 25 25 25 518 19 31 517 25 25 25 25 518 19 31 517 25 25 25 25 519 515 491 250 
12 12 12 12 12 12 12 12 12 12 12 12 12 12 12 12 12 520 521 522 523 12 12 12 12 12 12 12 12 12 12 12 12 520 521 522 523 12 12 12 12 12 520 521 522 523 12 12 12 12 12 12 12 12 520 521 522 523 12 12 12 12 12 12 12 520 521 522 523 12 12 12 12 12 12 12 12 12 12 520 521 522 523 12 12 12 12 12 12 12 12 12 510 511 512 516 32 32 32 32 524 19 31 32 32 32 32 32 524 19 31 32 32 32 32 32 524 19 31 32 32 32 32 32 32 515 491 250 
12 12 12 12 12 12 12 12 12 12 12 12 12 12 12 520 521 525 526 526 527 528 12 12 12 12 12 12 12 12 12 520 521 525 526 526 527 528 12 12 12 520 529 526 526 527 528 12 12 12 12 12 520 521 525 526 526 527 528 12 12 12 12 520 521 525 526 526 527 528 12 12 12 12 12 12 12 520 521 525 526 526 527 528 12 12 12 12 12 12 530 531 532 533 534 535 32 32 32 32 524 19 31 32 32 32 32 32 524 19 31 32 32 32 32 32 524 19 31 32 32 32 32 32 32 515 491 250 
12 520 521 536 522 523 12 12 12 12 12 12 12 12 520 529 526 526 526 526 537 538 539 540 520 521 536 522 523 12 520 529 526 526 526 541 537 538 540 12 12 542 543 526 541 537 538 544 12 12 12 520 529 526 526 526 541 537 538 540 12 12 520 529 526 526 526 541 537 538 539 545 521 522 523 12 520 529 526 526 526 541 537 538 540 12 12 12 12 12 510 546 547 548 549 550 58 59 60 32 524 19 31 32 58 59 60 32 524 19 31 32 58 59 60 32 524 19 31 32 58 59 60 32 32 515 491 250 
521 525 526 526 526 551 522 523 12 12 12 12 12 12 552 553 543 526 554 555 556 557 558 559 525 526 526 526 551 522 560 561 562 526 563 564 556 557 538 544 12 565 566 567 568 569 570 571 12 12 12 542 543 526 541 563 564 556 557 538 544 12 552 553 543 526 563 564 556 557 558 572 526 526 551 522 560 561 562 526 563 564 556 557 538 544 12 12 12 12 510 546 573 574 575 32 84 12 85 32 524 19 31 32 84 12 85 32 524 19 31 32 84 12 85 32 524 19 31 32 84 12 85 32 32 576 577 250 
526 526 526 526 578 526 526 551 536 522 523 12 12 12 565 579 580 567 581 582 583 584 585 526 526 526 526 526 526 526 526 586 587 588 581 589 590 591 570 571 12 12 12 592 593 594 12 12 12 12 12 565 566 567 568 581 589 589 590 570 571 12 565 579 580 567 581 582 583 584 585 526 526 526 526 526 526 586 587 588 581 589 590 591 570 571 12 12 12 520 595 546 573 596 597 32 84 12 85 32 524 19 31 32 84 12 85 32 524 19 31 32 84 12 85 32 524 19 31 32 598 536 599 32 32 600 32 250 
526 526 526 526 601 526 526 526 526 526 602 523 12 12 12 12 12 603 604 605 526 526 526 526 526 526 526 526 526 526 526 526 526 606 607 593 594 12 12 12 12 12 12 12 12 12 12 12 12 12 12 12 12 592 593 593 593 593 594 12 12 12 12 12 12 603 604 605 526 526 526 526 526 526 526 526 526 526 526 606 607 593 594 12 12 12 12 520 521 525 608 546 573 609 610 32 84 12 85 32 524 19 31 32 611 521 599 32 524 19 31 32 598 536 599 32 524 19 31 32 612 526 613 32 32 32 32 250 
614 615 616 617 618 619 616 620 614 615 616 621 622 623 624 625 626 627 628 629 614 615 616 620 614 615 616 620 614 615 616 620 614 615 630 625 622 623 624 625 622 623 624 625 622 623 624 625 622 623 624 625 622 623 624 625 622 623 624 625 622 623 624 625 622 627 616 620 614 615 616 620 614 615 616 620 614 615 616 620 631 623 624 625 626 623 632 633 614 615 616 634 635 636 637 638 639 623 640 638 641 642 643 638 641 615 644 638 641 642 643 638 641 615 644 638 641 642 643 638 641 615 644 638 645 646 647 648 
649 650 651 652 653 650 651 652 653 650 651 652 653 650 654 655 656 657 658 659 649 650 651 652 653 650 651 652 653 650 651 652 653 650 651 652 653 650 651 652 653 650 651 652 653 650 651 652 653 650 651 652 653 650 651 652 653 650 651 652 653 650 651 652 653 650 651 652 653 650 651 652 653 650 651 652 653 650 651 652 653 650 654 655 660 661 662 659 649 650 651 652 653 650 651 652 653 650 651 652 653 650 651 652 653 650 651 652 653 650 651 652 653 650 651 652 653 650 651 652 653 650 651 652 653 650 651 663 
664 665 666 667 668 669 666 667 668 669 666 667 668 669 670 671 529 526 526 526 664 665 666 667 668 669 666 667 668 669 666 667 668 669 666 667 668 669 666 667 668 669 666 667 668 669 666 667 668 669 666 667 668 669 666 667 668 669 666 667 668 669 666 667 668 669 666 667 668 669 666 667 668 669 666 667 668 669 666 667 668 669 670 671 521 525 526 526 664 665 666 667 668 669 666 667 668 669 666 667 668 669 666 667 668 669 666 667 668 669 666 667 668 669 666 667 668 669 666 667 668 669 666 667 668 669 666 672 
